Grillúo	Presume de sus nuevas pertenencias.	Mira al carajito con sus nuevos patines, todo grillúo.
Agarrao'	Avaro, con exceso de sentido de pertenencia.	Este coño si es agarrao, quiere toda vaina para él.
Gallitos	Sinónimo de Cotufas, Palomitas de Maíz, PopCorn.
Lampazo	Sin. de Coleto, Trapeador y Fregona.
Duro frío	Sinónimo del caraqueño Chupi-chupi.
Anafre	Es una parrillera improvisada que se hace con un rin de carro y abajo se coloca el carbón.
Vergatario	Grandeza.	Tu eres un vergatario en matemáticas.
Farfullos	Personas que hablan mucho pero hacen poco.
Bulla	Sinónimo griterío o ruido.	Que bulla!
Cabulla	hilo grueso.	Pasame la cabulla.
Verguero	Muchedumbre o pleito.
Vergajazo	Golpe violento, y un sinnúmero de expresiones similares.
Centellazo	Regaños fuertes. Descarga eléctrica descontrolada.
Bajareque	Pared hecha de bloques de concreto.
Abajar	Bajar de algún sitio.
Enchuflar	Enchufar, acción y efecto de conectar un dispositivo eléctrico en la respectiva toma eléctrica.
Esmadra'a	Caída contundente acompañada de laceraciones.
Cadillo	Es cuando una persona es muy fastidiosa e insistente.
Carraspera	Gripe mal curada, molestia en la garganta.
Cocí'o	Consiste en hervir un plátano, luego de ello triturarlo, y servirlo con margarina/mantequilla y queso.
Machucón	Golpe fuerte de un martillo en algún dedo acompañado de la palabra vergación.
Mojonero	Persona que dice mentiras o no está diciendo la verdad.	Vos si sois mojonero.
Mojonea'o	Se refiere a la persona que presume lo que no es (Echón).
Lagañúo	Que tiene lagañas en los ojos (Lagaña) Humor procedente de la mucosa y glándulas de los párpados, cuajado en el borde de estos o en los ángulos de la abertura ocular.
Esperola'a	Descuidada.
Morzá	Acción de comer al mediodía (solo los indios goajiros lo usan).
No quiere nada	expresión que se utiliza para denotar que alguna persona quiere mucho a otra y no desea que le pase nada malo.	¡¡Esa profesora no quiere nada conmigo!! (esa profesora me quiere mucho).
Alzao	Envalentonado.
Bomboncito	No es chocolate. Dícese de mujer agraciada de muy buen aspecto físico, que aparece en la página central de un diario local.
Explota'a	Mujer con cuerpo exuberante que llama la atención, También conocida como Reventaaaa ó Estallaaaa.
¡Soplao!	Ir a gran velocidad también se usa: esvergao, esvergatiao, esmollejao.
Guarapera	Vendedora de guarapo.
¡Piche!	Alimento en mal estado y con un profundo mal olor
Ladilla	Persona que molesta sin consideración.	Vos si sois ladilla...
¡Ladilla'o!	Persona que está sin hacer nada y en un estado de ocio, sin saber que hacer
Fresco	Bebida gaseosa a baja temperatura.	Mira vendeme un fresco pa la calor que me va a matar, Persona que abusa de la confianza de otro individuo.	por que agarraste eso sin permiso vos si sois fresco.
Sabañón	Micosis cutanea, alojada con frecuencia en los pies, pie de atleta, también llamado sabañon a la persona que come mucho (comeis mas que un sabañón).
Pecueca	Olor nauseabundo proveniente de los pies.
Violín	Hedor proveniente del sobaco, también conocido como ala caída o ala rota.	Tais violinúo.
Sobaco	Sinónimo de Axila, y que en los mayoría de los casos no ha sido rasurada nunca.
Flocho	Blando.
Frijolillo	de poca o ninguna voluntad.
Hecho golilla	hecho una piltrafa, borracho.
Cicutillo	Sucio que se forma en el cuello, la ingle, unión brazo-antebrazo, etc.
Saladillo	Sector tradicional de la ciudad, llamado de esa manera por haber sido construido sobre una mina de sal.
Tabardillo	Sinónimo de insolación. Efecto que causa al organismo la exposición prolongada bajo el sol ardiente.
Sebillo	(derivado del vocablo "sebo"): Esmegma. Palabra típica de la zona de Maracaibo, en una vulgaridad y se debe evitar o saber usarla con cuidado, se refiere al sucio que se acumula sobre el glande del pene del hombre, residuos de semen, etc.	Sebillúo, ¡Vete al sebillo!.
Sebillúo(a)	adjetivo que connota la distinción hacia una persona con aires de grandeza o muy alta autoestima, creído, altivo, presumido, pedante, petulante, fantasioso, fatuo. Marcando diferencias en el estatus social o económico. 'erga! (derivación fonética de verga). También connota alguien muy sucio, que no se baña, que huele mal (es muy ofensivo), Sinónimo de Sifrino.	¡Si es sebillúo!, Vos si sois sebillo Mardito!!!.
